FAFFFFFF
F0F0F0FF
FFFFFFFF
F0F0F0F0
FFFFFFFF
00F0F0F0
FFFFFFFF

0,0
6,6
EESSEENNWWSSEE
